两句恐怖故事第一季	悬疑,剧情	第6集
穿越时光的学校之旅第一季	剧情	第6集
太空猎手扫兴者第五季	科幻,惊悚,动作,冒险	第6集
黑水晶：抗战纪元第一季	奇幻,动画,冒险	第10集
前哨第二季	科幻,奇幻,冒险	第8集
灵异拼图第一季	罪案,剧情	全剧完结
全裸导演第一季	剧情,传记	本季终
凡人烦人第三季	罪案,悬疑,喜剧	全剧完结
凡人烦人第一季	罪案,悬疑,喜剧	全剧完结
凡人烦人第二季	罪案,悬疑,喜剧	全剧完结
南方女王第四季	罪案,惊悚,动作,剧情	第12集
氰化欢乐秀第一季	喜剧,动画	本季终
狂欢命案第一季	惊悚,悬疑,奇幻	本季终
秘密三人组第一季	动画	本季终
夏琳唐斯之死第一季	记录,罪案	本季终
不老域第一季	罪案,惊悚,悬疑	本季终
厨艺大师第十季	真人秀	第21集
暗礁第一季	罪案,悬疑	第11集
传教士第四季	魔幻,剧情,冒险	第5集
新飞越比弗利第一季	爱情	第4集
我们的男孩第一季	罪案,剧情	第4集
皮尔逊第一季	剧情	第7集
福尔摩斯：基本演绎法第七季	罪案,悬疑,剧情	全剧完结
更美好的事第三季	喜剧,剧情	第4集
波达克第五季	爱情,历史,剧情	全剧完结
婚外情第五季	都市,剧情	第1集
球手们第五季	喜剧,剧情	第1集
凡妮莎海辛第四季	科幻,奇幻,动作	预告
致命女人第一季	罪案,喜剧,剧情	第3集
小丑梦摇篮第四季	喜剧,剧情	本季终
行尸之惧第五季	惊悚,丧尸	第11集
永远十二岁第一季	青春,动画,剧情,冒险	第16集
黄石公园第二季	西部,剧情	第10集
少年正义联盟第三季	科幻,动画,冒险	第26集
四个婚礼一个葬礼第一季	爱情,喜剧	第8集
生活点滴第四季	喜剧	第11集
心灵风暴第一季	剧情	第6集
名姝第三季	剧情	第8集
成长不容易第二季	喜剧	第15集
另一面第一季	惊悚,历史,剧情	第12集
极速前进第三十一季	真人秀	本季终
蔗糖女王第四季	剧情	第6集
年轻一代第六季	爱情,喜剧	第11集
白粉飞第三季	罪案,剧情	第8集
黄金比例第一季	爱情,歌舞,悬疑,剧情	第2集
老大哥(美版) 第二十一季	综艺,真人秀	第28集
阴差阳错第三季	惊悚,悬疑,剧情	第1集
潘多拉第一季	科幻	第7集
朝上第一季	喜剧	第6集
极地恶灵第二季	惊悚,剧情	第3集
十三个原因第三季	悬疑,剧情	本季终
49号旅舍第二季	剧情	第3集
浴血黑帮第五季	罪案,剧情	第2集
美爪屋第三季	喜剧	第7集
本能第二季	罪案,剧情	第11集
神探默多克第十一季	罪案,爱情,悬疑,剧情	第14集
继承第二季	剧情	第3集
权欲第六季	罪案,剧情	第1集
苦甜曼哈顿第二季	剧情	本季终
太空终界第二季	科幻,动画	第10集
浮华饭店(美版)第一季	剧情	第11集
女作家与谋杀案第七季	罪案,悬疑,剧情	第12集
无声的证言第八季	罪案,剧情	第4集
潘尼沃斯第一季	罪案,动作,剧情	第6集
富家穷路第四季	喜剧	第9集
追寻人生第二季	都市,剧情	第13集
机器人大战第四季	真人秀	本季终
呼叫助产士第八季	历史,剧情	第8集
金装律师第九季	喜剧,剧情	第6集
节上生枝第一季	喜剧	第5集
姿态第二季	歌舞,历史,剧情	本季终
野兽家族第四季	罪案,剧情	本季终
发公主：剧集版第二季	爱情,奇幻,动画	第16集
好女巫第五季	魔幻,奇幻,喜剧	第6集
一路绕行第四季	喜剧	本季终
黑白恋曲第一季	爱情,暴力	第15集
信任之危第二季	惊悚,悬疑,剧情	第4集
山巅之城第一季	罪案,惊悚,剧情	本季终
超凡女仆第一季	剧情	本季终
心理神探第二季	罪案,惊悚,剧情	本季终
氪星第二季	科幻,动作,剧情,冒险	本季终
安迪・麦克第三季	青春,剧情	第7集
印度警探第一季	喜剧,剧情	第4集
侍女的故事第三季	科幻,剧情	本季终
阴阳界第一季	血腥,科幻,惊悚,悬疑,剧情	本季终
急诊室的故事第三季	医务,剧情	第8集
园丁女侦探第一季	罪案,悬疑,剧情	第6集
替身第一季	罪案,科幻,惊悚,悬疑,剧情	第8集
神圣游戏第二季	罪案,惊悚,动作,剧情	本季终
大群第三季	科幻,动作,剧情	全剧完结
我是第一季	剧情	第3集
最响亮的声音第一季	剧情	第7集
人类发现第一季	动画	第6集
喜新不厌旧第五季	喜剧	第16集
无限恩典有限公司第一季	剧情	本季终
纯心英雄第一季	动画,冒险	第6集
街角少年第一季	剧情	本季终
接线女孩第四季	爱情,剧情	本季终
黑心钱第一季	剧情	第4集
女飞贼杰特第一季	罪案,动作	本季终
